{
  "行く": "N5",
  "勉強する": "N5",
  "勉強": "N5",
  "なる": "N5",
  "ない": "N4",
  "ます": "N5",
  "ん": "N4"
}

